 +++++++++++++++++++++++++++++++++++++++++++++++++++++
 +                 +                                 +
 +   +++++++   +   +   +++++++   +++++   +++++++++++++
 +   +   +     +         +   +   +   +               +
 +   +   +++++++++   +   +   +   +   +++++++++++++   +
 +         +         +       + ? +               +   +
 +++++++++++++++++++++   +   +++++++++   +++++   + * +
 +               +   +   +           +   +   +   +++++
 +   +   +++++   +   +   +   +++++++++   +   +   +   +
 +   +       +   +   +   +           +   +       +   +
 +   +++++   +++++   +++++++++++++   +   +   +++++   +
 +   +       +                       +   +       +   +
 +   +++++   +   +++++++++++++++++++++   +++++ ? +   +
 +       +     ! +           +   +       +       +   +
 +++++   +++++++++   +   +   +   +   +++++   +++++   +
 +           +       +   +       +   +       +       +
 +   +++++++++   +++++   +++++   +   +   +++++   +   +
 +               +       +           +   +       +   +
 +++++++++++++++++++++++++   +++++++++   +   +++++   +
 +       +               +               +   +       +
 +   +   +   +   +++++   +++++   +++++++++   +   +   +
 +   + !     +       +           +       +   +   +   +
 +   +++++++++++++++++++++++++++++   +   +   +   +   +
 +       +                           +   +   +   +   +
 +   +   +   +++++++++++++++++   +   +   +   +   +++++
 +   +               =           +   +       +       E
 +++++++++++++++++++++++++++++++++++++++++++++++++++++
